1111111111111111111111111111111111111111111111111111111111111111111111111111111111111111111
1001000000010000000001000000000000000000000100000000000000000000000000000000000000000000001
1001010000010000000001010000000000000000010100000000000000000000000000000000000000000000001
1001010P0001000000000101000000000000000001010000000000000000000000000000000000CCCC000000001
100101000001000000000101000000000000000001010000000000000000000000000000000000CCCC000000001
10010100000100000000010100000000000000000101000000C000000000000000000000000000CCCC000000001
100101000001000000000101000000000000000001010000000000000000000000000000000000CCCC000000001
100101000001000000000101000000000000000001010000000000000000000000000000000000CCCC000000001
100101000001000000000101000000000000000001010000000000000000000000000000000000CCCC000000001
100101000001000000000101000000000000000001010000000000000000000000000000000000CCCC000000001
100000000000000000000000000000000000000000000000000000000000000000000000000000CCCC000000001
100000000000000000000000000000000000000000000000000000000000000000000000000000CCCC000000001
100100000001000000000100000000000000000000010000000000000000000000000000000000CCCC000000001
100101000001000000000101000000000000000001010000000000000000000000000000000000CCCC000000001
100101000001000000000101000000000000000001010000000000000000000000000000000000CCCC000000001
100101000001000000000101000000000000000001010000000000000000000000000000000000CCCC000000001
10010100000100000000010100000000000000000101000000C000000000000000000000000000CCCC000000001
100101000001000000000101000000000000000001010000000000000000000000000000000000CCCC000000001
100101000001000000000101000000000000000001010000000000000000000000000000000000CCCC000000001
100101000001000000000101000000000000000001010000000000000000000000000000000000CCCC000000001
100101000001000000000101000000000000000001010000000000000000000000000000000000CCCC000000001
100000000000000000E000000000000000000000000000000000000000000000000000000000000000000000001
1111111111111111111111111111111111111111111111111111111111111111111111111111111111111111111
