11111111111111111111111111111111111111111
10000000000000000000000000000000000000001
10010100000100000000000000000000001010001
1001010P000100000000000000000000001010001
10010100000100000000000000000000001010001
10010100000100000000000000000000001010001
10010100000100000000000000000000C01010001
10010100000100000000000000000000001010001
10010100000100000000000000000000001010001
10010100000100000000000000000000001010001
100000000000000000000000000000000000000E1
10000000000000000000000000000000000000001
10000000000000000000000000000000000000001
10000000000000000000000000000000000000001
11111111111111111111111111111111111111111
