1111111111111111111111
10C00000000001C0000C01
1001010001000100001C01
1001010P01000100001C01
100101000100C101001C01
10C10100C1000101001C01
1000C000000C0001000C01
1000C000000C0001000C01
10000000000000E1000C01
1111111111111111111111