1111111111111111111111111111
1P0000XCXCXXC11CXXCXCX0000P1
1111X010000001100000010X1111
10C1C010111101101111010C1C01
10X1X000000001100000000X1X01
1C000011111111111111110000C1
1XC1000000000110000000001CX1
1111111111110000111111111111
1111111111111EX1111111111111
1111111111111111111111111111