1111111111111111
10X11C001C0010E1
1P00101010101011
10XP101010101C11
10X11010101C1011
10000C1000100011
1111111111111111