11111111111111111111111111
1P0001000000000000000000X1
100100000000000X00000000P1
11X10111111111111111111111
1C01010000000X000000P0X001
110101111X1111111110111101
1C010100000X000000000011C1
1X01010000010C0000000XX001
1001010011110000100XX00001
100000000000000010X0000C01
1X110110111111111111101101
100X01000000000000000010E1
11111111111111111111111111