11111111111
100E1000011
101110110C1
101C1011011
100000C10P1
11111111111