111111111111111111111111111111111
11X111111111111111111111111111X11
1XP0000XCXCXXC11111CXXCXCX0000PX1
11X11X010000001111100000010X11X11
110C1C010111101111101111010C1C011
110X1X000000001111100000000X1X011
11C000011111111111111111110000C11
11XC1000000000001000000000001CX11
111111111111111000111111111111111
1111111111111110E0111111111111111
111111111111111000111111111111111
11XC1000000000001000000000001CX11
11C000011111111111111111110000C11
110X1X0000000P11111P0000000X1X011
110C1C010111101111101111010C1C011
11X11X010000001111100000010X1XX11
1XP0000XCXCXXC11111CXXCXCX0000PX1
11X111111111111111111111111111X11
111111111111111111111111111111111